111111111111111
10001C0011C0001
1E1001000011001
1110001C1111101
10001C000000CP1
111111111111111