111111111111111111111111111111
10001C0011C0000A0001C0011C0001
1E100100001100000100100001A001
1110001C111110AA110001C1111C01
1A001C000000CP00A001C000000C11
10001C0011C000AA0001C0011C0001
101001000011000001001000001001
1110001C11111011110001C1111001
1A001C000000C011A001C000000C01
111111111111111111111111111111